,TickerID,Symbol,Name,Occurrence,Positive,Negative
0,913253340,TCCO,Technical Comm,4,3,1
1,913303716,ATNM,ACTINIUM PHARMAC,52,32,20
2,913303741,ARMP,Armata Pharmaceuticals Inc,3,3,0
3,913303798,IDN,INTELLICHECK,3,3,0
4,913303872,UUU,UNIV SEC INSTR,3,3,0
5,925170974,YTRA,Yatra Online,3,3,0
6,925194354,BYSI,BeyondSpring,3,3,0
7,925237429,KRMD,Repro Med System,3,3,0
8,925402060,ZOM,Zomed Pharm,84,60,24
9,950102389,NKLA,Nikola Corporation,99,51,48
10,913253479,AKTX,Akari,1,0,1
11,913253654,SHIP,Seanergy,44,15,29
12,913255766,TNXP,Tonix,3,1,2
13,913431418,NOVN,Novan,2,0,2
14,925117488,GNUS,Genius Brands,223,90,133
15,913244544,USO,United States Oil,45,24,21
16,913247321,JNUG,Direxion Daily Jr Gld Mnrs Bull 2X ETF,37,23,14
17,913254192,MARK,Remark Holdings,71,46,25
18,913255088,CHK,Chesapeake Enrgy,30,19,11
19,913255171,DAL,Delta Air,59,35,24
20,913255666,NCLH,Nrwn Crs Ln Hldg,35,22,13
21,913257561,NVDA,Nvidia,33,21,12
22,950122583,LK,Luckin Coffee,78,41,37
23,950153166,DKNG,DraftKings Inc,43,24,19
24,913324442,TNK,Teekay Tankers,1,0,1
25,913254165,TOPS,Top Ships,25,13,12
26,913243251,SPY,SPDR® S&P 500 ETF Trust,202,101,101
27,913254830,HTZ,Hertz Glo Hldg,178,87,91
28,913255078,CCL,Carnivl,48,28,20
29,913255655,SAVE,Spirit Airlines,17,5,12
30,913256135,AAPL,Apple,181,100,81
31,913323997,MSFT,Microsoft,51,32,19
32,925376726,ROKU,Roku,31,14,17
33,913255275,F,Ford Motor,52,27,25
34,913255447,JPM,JPMorgan,8,1,7
35,913255598,TSLA,TESLA,261,140,121
36,913323111,JPM PRG,JPMORGAN CHASE,2,0,2
37,913253515,EFOI,Energy Foc,8,7,1
38,925299128,ACB,Aurora Cannabis,130,71,59
39,950060046,BE,Bloom Energy,2,2,0
40,950076017,NIO,NIO Inc.,25,20,5
41,913303672,IBIO,IBIO,16,13,3
42,925178405,MGEN,Miragen Therapeutics,8,3,5
43,913253338,XSPA,XPRESSPA GROUP,47,29,18
44,913253350,GLBS,Globus Maritime,3,2,1
45,950106773,TBLT,Toughbuilt Industries,3,2,1
46,913255467,KR,Kroger,21,11,10
47,913246052,TVIX,VelocityShares Daily 2x VIX ST ETN,68,38,30
48,913253685,CARV,Carver Bancorp,7,3,4
49,913257027,NFLX,Netflix,26,7,19
50,916040668,BRK.B,Berkshire Hatha,1,0,1
51,913253384,CLIR,ClearSign Technologies Corp,14,11,3
52,913254234,MTSL,MER TELEMANAG,13,13,0
53,925418530,IQ,IQIYI Inc,11,11,0
54,950052430,SPCE,Virgin Galactic Holdings Inc,79,51,28
55,913254245,AXAS,Abraxas Petro,17,6,11
56,913256180,AMZN,Amazon.com,57,36,21
57,913256131,ZN,Zion Oil and Gas,71,32,39
58,913354088,NDX,NASDAQ 100 Index,2,2,0
59,913354090,IXIC,NASDAQ,2,1,1
60,913354362,INX,S&P 500,3,2,1
61,950118416,DOW,Dow Inc,5,1,4
62,913323899,NE,Noble Corp,5,0,5
63,925338433,FORW,Forwardly Inc,4,1,3
64,913303875,WYY,WIDEPOINT,5,1,4
65,925239342,VRME,VerifyMe,2,0,2
66,925286359,ROSE,Rosehill,3,1,2
67,925415125,FAMI,Farmmi,7,1,6
68,913255859,NERV,Minerva,6,3,3
69,913253680,BYFC,Broadway Finl,3,0,3
70,913254871,ORN,Orion Grp Hldg,3,0,3
71,913255004,BBX,BBX Capital Corp,3,0,3
72,913256024,ALPN,Alpine Immune,3,0,3
73,913303894,REXN,REXAHN PHARMA,3,0,3
74,919226054,IDEX,Ideanomics Inc,24,13,11
75,925347616,HUSN,Hudson Capital Inc,5,0,5
76,925381596,AESE,Allied Esports Entertainment,5,0,5
77,913254269,OAS,OASIS PETROLEUM,59,30,29
78,913254998,BA,Boeing,97,53,44
79,913255803,AAL,American Airlines,61,28,33
80,913303886,HUSA,HOUSTON AMERICAN,6,2,4
81,913255820,NVFY,Nova LifeStyle,6,3,3
82,913254235,AMD,AMD,71,31,40
83,950102542,MRNA,Moderna,51,32,19
84,913324546,WLL,Whiting Petrol,54,36,18
85,913253467,TRCH,Torchlight,1,0,1
86,925415318,LIVX,Livexlive Media,1,0,1
87,925418550,HPR,HighPoint Rsrcs,9,6,3
88,913255807,GNCA,Genocea,1,0,1
89,913253498,OXBR,Oxbridge Re Hldg,2,0,2
90,913253635,SCKT,Socket Mobile,2,0,2
91,913255829,MDWD,Mediwound,3,1,2
92,913257362,KIRK,Kirklands,3,1,2
93,925419461,IEA,INFRASTRUCTURE A,3,1,2
94,950110764,ANCN,ANCHIANO THERAPEUTICS LTD.,3,1,2
95,950135696,HCCHR,HL Acquisitions Corp,3,0,3
96,950104120,BYND,Beyond Meat,69,44,25
97,950085007,OSMT,Osmotica Pharmaceuticals Plc,1,0,1
98,950065193,BNGO,Bionano Genomics,3,1,2
99,913253607,NMTR,9 Meters Biopharma,2,0,2
100,913254324,DQ,Daqo New Energy,1,1,0
101,913256393,CSIQ,Canadian Solar,1,1,0
102,913324673,JKS,JinkoSolar,1,1,0
103,913433140,SUNW,Sunworks,2,1,1
104,913324007,MVIS,MicroVision,17,9,8
105,913253390,CEMI,Chembio,3,2,1
106,913253421,AFH,Atlas Fin Hldgs,2,0,2
107,913255414,IBM,IBM,7,4,3
108,950110807,N/A,BITWISE BITCOIN ETF TRUST,7,4,3
109,950126584,N/A,Cipher Technologies Bitcoin Fund,8,4,4
110,913254558,BABA,Alibaba,90,67,23
111,925186755,SNAP,Snap,47,25,22
112,950118595,ZM,ZOOM VIDEO,44,18,26
113,913403631,531268,B2B SOFTWARE-XT,9,3,6
114,913243846,VGT,Vanguard Information Technology ETF,2,0,2
115,913254450,HCR,Hi-Crush Partner,2,0,2
116,913244089,GLD,SPDR® Gold Shares,4,1,3
117,913244138,IAU,iShares Gold Trust,1,1,0
118,913730084,GOLD,Barrick Gold,6,1,5
119,913256732,GILD,Gilead Sciences,36,15,21
120,913323727,MDRIQ,McDermott Intern,25,17,8
121,913253526,CFRX,ContraFect,9,7,2
122,913253759,CHNR,CHNR,5,4,1
123,913253453,BIOC,Biocept,18,11,7
124,913253721,PSTV,Plus Therapeutics Inc,13,7,6
125,925348770,AVCT,American Virtual Cloud Technologies,22,18,4
126,950134087,BORR,BORR DRILLING LTD,13,4,9
127,913255327,GE,GE,28,14,14
128,913323745,MFA,MFA Fncl,59,37,22
129,913255192,DIS,Walt Disney,106,56,50
130,913324645,IVR,Invesco Mortgage,7,2,5
131,925242609,AZUL,Azul,3,0,3
132,913255126,CPE,Callon,11,6,5
133,916040768,NTEC,Intec Pharma,27,18,9
134,913255341,GME,GameStop,3,0,3
135,913253622,IZEA,IZEA Worldwide,3,1,2
136,913254999,BAC,Bank of America,8,3,5
137,913255353,GS,Goldman Sachs,3,2,1
138,913256458,FORR,Forrester,2,2,0
139,913324369,SAN,Banco Santander,5,4,1
140,913324537,WFC,Wells Fargo,6,2,4
141,913903086,BRK.A,Berkshire Hatha,2,2,0
142,916040709,DB,Deutsche Bank,2,2,0
143,913253630,VTGN,VistaGen,1,0,1
144,925377982,LYL,Dragon Victory,2,0,2
145,950109011,JFIN,Jiayin Group,2,0,2
146,950125354,WAFU,Wah Fu Education Group Ltd,1,0,1
147,925323875,VIX,CBOE Market Volatility Index,6,5,1
148,925415088,VXX,iPath® B S&P 500® VIX S/T Futs™ ETN,10,7,3
149,913303712,ENSV,ENSERVCO,16,8,8
150,913256394,CSWC,CSWC,3,1,2
151,913255055,C,Citigroup,3,0,3
152,913323815,MS,Morgan Stanley,3,0,3
153,913323901,NEM,Newmont Corp,3,0,3
154,913433476,PAAS,Pan Amer Silver,3,0,3
155,916040647,AEM,Agnico Eagle,3,0,3
156,913254620,GRUB,GrubHub,3,1,2
157,913256535,CRIS,Curis,21,13,8
158,913254339,KOS,Kosmos Energy,6,5,1
159,913324070,OXY,Occidental,4,4,0
160,913303773,DPW,DPW HOLDINGS,15,10,5
161,913303985,LTRPB,Liberty Trip,5,2,3
162,913255330,GES,Guess,1,0,1
163,913253346,BIMI,BOQI International Medical Inc,14,9,5
164,913257299,GOOGL,Alphabet,7,1,6
165,913286916,GOF,Guggenheim Strategic Opp Fund,4,0,4
166,913303928,FB,Facebook,31,15,16
167,913324551,WMT,WalMart,6,1,5
168,925354277,IE00B1FQCP82,DWS Noor Precious Metals Secs B,4,0,4
169,925415154,DMGGF,Dmg Blockchain,4,0,4
170,950056100,PRVB,"PROVENTION BIO, INC.",4,0,4
171,950138392,PTON,Peloton Interactive Inc,2,0,2
172,913256109,SELB,Selecta,2,0,2
173,925187560,INPX,Inpixon,2,0,2
174,913353822,DJI,DOW JONES,10,5,5
175,950053134,ELOX,ELOXX PHARMACEUT,5,1,4
176,913323699,TWMC,Trans World Ent,1,1,0
177,913254553,TWTR,Twitter,4,3,1
178,913253567,AQMS,Aqua Metals,1,0,1
179,913323175,MYSZ,My Size,6,4,2
180,913253619,ROSEU,Rosehill,2,2,0
181,913254240,HHT,Color Star Technology,2,2,0
182,913323769,MLM,Martin Mari Mat,2,2,0
183,913324585,XOM,Exxon Mobil,3,0,3
184,913253343,HGSH,China HGS,3,0,3
185,913254231,BBI,Brickell Biotech Inc,15,7,8
186,913257452,NCTY,The9 Ltd,3,0,3
187,913303771,BGI,BIRKS GROUP,3,0,3
188,950084925,WKEY,WISEKEY INTERNAT,3,0,3
189,913254746,SHOP,Shopify,5,2,3
190,913256616,DXCM,DexCom,2,1,1
191,913420438,BTCUSD,Bitcoin/US Dollar,10,5,5
192,913431510,TTD,Trade Desk,1,1,0
193,925335623,SOLO,Electrameccanica Vehicles Corp,6,1,5
194,925302410,CLPPZ,Clipper Realty,7,3,4
195,913253438,VISL,Vislink Technologies Inc,23,9,14
196,913254883,UAL,United Airlines Holdings Inc,2,2,0
197,913324267,RIG,Transocea,2,2,0
198,913253365,ENT,Global Eagle Ent,2,1,1
199,913253612,NAKD,Naked Brand,10,5,5
200,913256051,XELB,Xcel Brands,1,0,1
201,913323994,NTZ,Natuzzi,1,0,1
202,925328913,IMRN,Immuron,1,0,1
203,950097047,MTC,MMTEC INC,1,0,1
204,913254359,MITT,AG Mortgage,2,2,0
205,925409377,DLPN,Dolphin,25,14,11
206,913254575,EROS,Eros,23,9,14
207,913323171,WTRH,Waitr Holdings Inc,22,8,14
208,913256200,CIDM,Cinedigm,33,13,20
209,913243044,UGAZ,VelocityShares 3x Long Natural Gas ETN,31,13,18
210,913253748,IDRA,Idera Pharma,1,1,0
211,913254243,TENX,Tenax Therapeut,1,1,0
212,913324076,MGI,MoneyGram Intl,2,1,1
213,925401759,AMRH,Ameri Holdings,2,2,0
214,913253569,CETX,Cemtrex,11,5,6
215,913253691,DGLY,Digital Ally,11,4,7
216,913255599,AMRS,Amyris,4,2,2
217,950052414,VTSI,VIRTRA,4,2,2
218,913255648,FRAN,Francesca's,3,1,2
219,913256126,OPK,OPKO Health,4,2,2
220,925347608,ARPO,Aerpio Pharms,11,7,4
221,913255501,LUV,Southwest,3,2,1
222,950148888,N/A,Quantum Computing Inc.,2,0,2
223,913255615,OXLC,Oxford Lane Capital Corp,12,9,3
224,913253557,QLGN,Ritter Pharms,1,1,0
225,913324154,ATVI,Activision,3,2,1
226,913256010,NVIV,InVivo,14,7,7
227,925415195,VXRT,VAXART,14,10,4
228,913256159,AMRN,Amarin,3,2,1
229,925334606,CODX,Co-Diagnostics,2,2,0
230,913323458,ISBC,Investors,2,1,1
231,913253544,CHEK,Check Cap,20,11,9
232,913255911,TTOO,T2 Biosystems,4,3,1
233,913244660,GUSH,Direxion Dly S&P Oil&Gs Ex&Prd Bl 2X ETF,1,1,0
234,913303964,GOOG,Alphabet,3,3,0
235,913324336,SKT,Tanger Factory,1,1,0
236,925307064,CGC,Canopy Growth,14,12,2
237,925344301,PETQ,PetIQ,1,0,1
238,925185381,FVAL,Fidelity® Value Factor ETF,2,0,2
239,913256822,FCEL,FuelCell Energy,6,2,4
240,913253596,TTNP,Titan Pharma,5,2,3
241,925284416,CLDR,Cloudera,2,1,1
242,913323829,UNFI,Utd Natural Fds,1,0,1
243,913253640,LBCC,Long Blockchain,1,0,1
244,925283811,WMMVY,Wal-Mart Mexico,1,0,1
245,925300297,BLOZF,Cannabix Tech,2,0,2
246,950141558,PHAT,"PHATHOM PHARMACEUTICALS, INC.",1,0,1
247,913255963,MOMO,Momo,2,1,1
248,913256249,BCRX,BioCryst Pharms,3,0,3
249,925297441,ALO,Alio Gold,1,0,1
250,950145441,ALUS.U,ALUSSA ENERGY ACQUISITION CORP.,1,0,1
251,925308960,BCII,Blockchain Inds,1,0,1
252,950133094,ANVS,"ANNOVIS BIO, INC.",1,0,1
253,913253450,SQBG,Sequential,2,1,1
254,913255783,PBPB,Potbelly,1,0,1
255,950121423,UBER,Uber,2,1,1
256,913254798,SQ,Square,1,0,1
257,913257500,SGMO,SANGAMO THERAPEU,4,0,4
258,913324397,T,AT&T,1,0,1
259,913255659,ENPH,Enphase Energy,3,1,2
260,913254392,FET,Forum Energy Tec,23,16,7
261,913254548,CHGG,Chegg,3,3,0
262,913256489,CATM,Cardtronics,3,3,0
263,925284419,XRF,CHINA RAPID FINA,5,5,0
264,950056124,LOVE,Lovesac Co.,5,4,1
265,913254691,VSLR,Vivint Solar,1,0,1
266,913254288,SIX,Six Flags Entmt,1,0,1
267,925335305,HEXO,HEXO Corp,6,3,3
268,913254389,LPI,Laredo Petroleum,4,3,1
269,913255440,JCPNQ,JC Penney,6,2,4
270,913255260,VAL,Valaris plc,5,2,3
271,913431404,CDEV,Centennial Rsrc,2,1,1
272,925178113,TELL,TELLURIAN,2,1,1
273,925336029,CHAP,Chaparral Energy,3,1,2
274,913255096,CIR,CIRCOR Intl,2,2,0
275,913255915,RWLK,Rewalk,2,2,0
276,925379743,ALNA,Allena,3,3,0
277,950109827,DELL,Dell Technologies Inc.,1,0,1
278,913247322,JDST,Direxion Daily Jr Gld Mnrs Bear 2X ETF,4,2,2
279,913254588,LADR,Ladder Capital,5,2,3
280,913257234,OSTK,Overstock com,17,14,3
281,925302871,CNTTQ,CANNTRUST HOLDINGS,10,10,0
282,950142406,DUO,FANGDD NETWORK GROUP LTD.,1,0,1
283,913915147,LSI,Life Storage,5,0,5
284,913323666,LTMAQ,Latam Airlines,8,6,2
285,913256038,NBRV,Nabriva,8,3,5
286,925179328,SGLB,Sigma Labs,3,3,0
287,950061748,CANG,Cango,1,0,1
288,913254839,GEL,Genesis Eny,1,0,1
289,913244652,MJ,ETFMG Alternative Harvest ETF,5,4,1
290,913253457,SRNE,Sorrento Thera,6,1,5
291,913253636,UAVS,AGEAGLE AERIAL,3,1,2
292,913254222,PLUG,Plug Power,6,3,3
293,913254382,TSE,Trinseo,1,1,0
294,913254828,COE,CHINA ONLINE,1,1,0
295,913323335,CUK,Carnival,1,0,1
296,913255459,KMB,Kimberly Clark,3,1,2
297,913256936,SOHO,Sotherly Hotels,2,1,1
298,925240580,AYTU,Aytu BioScience,20,11,9
299,925412021,BLOK,Amplify Transformational Data Shrg ETF,1,1,0
300,913324248,RCL,Royal Carib Crus,1,1,0
301,913255934,PLAY,DAVE BUSTERS ENT,2,1,1
302,913254678,MDLY,Medley Mgmt,5,1,4
303,925173508,YTEN,Yield10,1,0,1
304,950122955,IDYA,Ideaya Bioscienc,1,1,0
305,913253575,AEMD,Aethlon Med,3,1,2
306,925416163,BTAI,BIOXCEL THERAPEU,1,0,1
307,913253796,CLWT,Euro Tech Hldgs,2,1,1
308,913253666,JAN,JanOne Inc,1,1,0
309,913303896,MHH,MASTECH DIGITAL,1,1,0
310,913253595,STAF,Staffing 360,1,0,1
311,913253705,EVOL,Evolving Systems,1,0,1
312,913303725,VOLT,VOLT INFO SCI,1,0,1
313,913323093,PAACR,Metlife Inc,1,0,1
314,950136125,CLEU,CHINA LIBERAL EDUCATION,2,1,1
315,913253566,MYT,Urban Tea Inc,2,1,1
316,925401987,KXIN,Kaixin Auto Holdings,1,0,1
317,925344591,NEWA,Newater Tech,2,1,1
318,913323315,UONE,Urban One,4,1,3
319,913253594,COOP,Mr. Cooper,2,0,2
320,913256115,TPIC,TPI Composites,2,1,1
321,913256036,RUN,Sunrun,1,1,0
322,925173120,CEI,Camber Energy,3,2,1
323,925353979,PACD,Pacific Drilling,1,0,1
324,950106571,AGE,AgeX Therapeutics,1,0,1
325,950136925,MNPR,Monopar Therapeutics Inc,1,0,1
326,913255700,HEAR,Turtle Beach,1,0,1
327,913303951,HSTO,Conatus Pharmaceuticals,2,1,1
328,913303667,EMAN,EMAGIN,3,1,2
329,950069438,SFET,SAFE-T GROUP LTD.,2,0,2
330,913253507,ZSAN,Zosano Pharma,1,1,0
331,913323104,KTOV,Kitov Pharms,3,1,2
332,913253442,IPWR,Ideal Power,1,1,0
333,925303986,HMGN,Hemagen Diag,1,1,0
334,913253668,ARTW,Art's-Way Mf,1,0,1
335,925352531,ZKIN,ZK Intl Group,1,0,1
336,925402203,RETO,RETO ECO SOLN,1,0,1
337,950150837,MEDS,"TRXADE GROUP, INC.",1,0,1
338,913253573,ANIX,Anixa Biosciences Inc,1,0,1
339,913255716,RGLS,Regulus,1,0,1
340,913323022,BVXV,BiondVax,1,0,1
341,913323065,BNTC,Benitec Biopharma,1,0,1
342,925239668,DYAI,Dyadic,1,0,1
343,925412756,MNLO,MENLO THERAPEUTC,1,0,1
344,950143140,CNTG,CENTOGENE B.V.,1,0,1
345,913256215,CLDX,Celldex,1,0,1
346,913368679,CGL,iShares Gold Bullion ETF (CAD-Hedged),1,1,0
347,913253351,OSN,OSSEN INNOVATION,1,1,0
348,950102663,LOACR,Longevity Acquisition,1,0,1
349,913253605,WINS,Wins Fin Hldg,1,1,0
350,913254170,TSRI,TSR Inc,1,0,1
351,913255984,MFH,Mercurity Fintech Holding,1,0,1
352,925117213,LLIT,Lianluo Smart,1,0,1
353,913323107,ANDAR,Andina Acqsn 3,1,0,1
354,925238925,AGTK,Agritek Holdings,1,0,1
355,913253431,OTEL,Otelco,1,1,0
356,913255587,VEON,VEON,1,1,0
357,913323563,ORBC,ORBCOMM,1,1,0
358,916040690,CEL,Cellcom Israel,1,1,0
359,925340912,PIXY,Shiftpixy,2,2,0
360,913253555,XELA,EXELA TECHNOLOGI,1,0,1
361,913246631,SPXS,Direxion Daily S&P 500® Bear 3X ETF,3,2,1
362,913255508,M,Macy's,26,15,11
363,925338008,NWEGF,Norwegian Finans,1,1,0
364,913273826,CANIX,Cannabis Growth Institutional,1,0,1
365,913323709,MCD,McDonalds,2,0,2
366,913324095,PCG,PG&E Us,3,2,1
367,913254364,RENN,Renren,2,1,1
368,913254216,AYRO,DropCar,6,4,2
369,913253348,CCCL,China Ceramics,7,5,2
370,925381877,HX,Hexindai,2,0,2
371,913255395,HPQ,HP Inc,1,1,0
372,913303742,XTNT,XTANT MEDICAL,6,1,5
373,913256106,ALJJ,ALJ REGIONAL,1,0,1
374,913323117,NNDM,Nano Dimension,5,2,3
375,916040696,PHUN,Phunware Inc,2,0,2
376,913324577,X,U. S. Steel,1,0,1
377,913254523,S,Sprint Corp,7,4,3
378,913255817,AGTC,AGTC,1,1,0
379,913323784,MNIQQ,McClatchy,1,0,1
380,913324495,UPS,UPS,1,0,1
381,913324572,WWE,WWE,1,0,1
382,913324606,NAV,Navistar Intl,2,2,0
383,913256223,ARAY,Accuray,2,1,1
384,913254992,AYI,Acuity Brands,1,0,1
385,913255289,FDX,FedEx,1,0,1
386,913323823,MSM,MSC Industrial,1,0,1
387,913256242,OPCH,Option Care Health Inc.,2,1,1
388,913255471,KSS,Kohls,2,0,2
389,913324118,PFE,Pfizer,1,0,1
390,913243222,XLE,Energy Select Sector SPDR® ETF,1,0,1
391,913255163,CVX,Chevron,1,0,1
392,925213942,NTRP,Neurotrope,1,1,0
393,913253344,LEDS,SemiLEDs,2,1,1
394,913253644,SNCA,Seneca Biopharma,2,2,0
395,913323655,IMBI,iMedia Brands,1,1,0
396,925409423,BTCUSD,BTC,4,1,3
397,925163605,RIOT,Riot Blockchain,12,8,4
398,925409426,XRPUSD,XRP,8,4,4
399,925409431,ETCUSD,ETC,10,4,6
400,950084520,ETCG,ETHEREUM CLASSIC,8,4,4
401,913253468,TACO,Del Taco,2,2,0
402,913262365,CM,CIBC,4,4,0
403,913253482,PHIO,Phio Pharmaceuticals Corp,3,3,0
404,913253683,CBLI,Cleveland Biolbs,3,3,0
405,913256199,AKRXQ,Akorn,5,4,1
406,913262246,BMO,BMO,3,3,0
407,913262257,BNS,Bank Nova,3,3,0
408,913262344,CHE.UN,Chemtrade Logis,3,3,0
409,913263299,NA,Natl Bk Canada,3,3,0
410,913263737,RY,RBC,3,3,0
411,913263990,TD,TD,3,3,0
412,913253466,ADMP,Adamis Pharma,1,1,0
413,913255683,VSTM,Verastem,1,1,0
414,913255996,KMPH,KemPharm,1,1,0
415,913303784,AIM,AIM ImmunoTech Inc,2,1,1
416,925283682,ZOM,Zomed Pharm,1,1,0
417,913254745,PRTY,Party Cty Holdco,4,2,2
418,925241998,NNDM,Nano Dimension,5,4,1
419,913253469,ALDX,Aldeyra,1,0,1
420,913254904,ABR,Arbor Realty Tr,2,2,0
421,925194271,JILL,J.Jill,1,0,1
422,913830678,EGO,Eldorado Gold,3,1,2
423,916040760,IAG,IAMGOLD Corp,1,0,1
424,916040771,AUY,Yamana Gold,6,4,2
425,913254649,WPG,WASHINGTON PRIME,3,1,2
426,913255068,CBL,CBL & Associates,1,1,0
427,913254810,YRD,Yiren Digital Ltd,1,1,0
428,913303902,TAT,TRANS PETROLEUM,6,5,1
429,913303755,APT,ALPHA PRO TECH,1,1,0
430,925195666,LLEX,Lilis Energy Inc,5,4,1
431,913255266,ET,Energy Transfer LP,4,3,1
432,913255627,RNET,RigNet,1,0,1
433,913324112,PEI,PREIT,2,1,1
434,913303779,GTE,GRAN TIERRA ENERGY,1,1,0
435,913303800,BRN,BARNWELL INDS,1,1,0
436,913323952,MIND,Mitcham Industri,1,1,0
437,913323255,TEVA,Teva Pharm Ind,2,1,1
438,913253561,CRBP,Corbus Pharms,4,2,2
439,913255896,ATRA,Atara Biotherapeutics Inc,1,1,0
440,913253673,GNSS,Genasys Inc.,2,2,0
441,913254837,BIO,Bio Rad,2,2,0
442,913256727,CYBE,CyberOptics,2,2,0
443,913323281,AZN,AstraZeneca,2,2,0
444,913323644,SPPI,Spectrum Pharma,2,2,0
445,913323757,VOD,Vodafone Group,2,2,0
446,913324222,FTNT,Fortinet,2,2,0
447,925293492,ALT,Altimmune,2,2,0
448,950063596,AQST,Aquestive Therapeutics,2,2,0
449,950145430,EH,EHang Holdings Ltd,2,2,0
450,913253389,CRDF,Cardiff Oncology Inc,1,1,0
451,913255511,MAC,Macerich,5,3,2
452,913323867,JBLU,JetBlue Airways,1,0,1
453,913255363,HAL,Halliburton,1,1,0
454,913255465,KO,Coca-Cola,7,6,1
455,913323854,PTEN,Patterson-UTI,1,1,0
456,913323886,NBR,Nabors Inds,2,2,0
457,913424717,UVXY,ProShares Ultra VIX Short-Term Futures,9,7,2
458,913244794,SDOW,ProShares UltraPro Short Dow30,2,2,0
459,925293281,EVIX,VelocityShares 1x Long VSTOXX Futs ETN,2,2,0
460,913243476,MLPQ,UBS ETRACS 2xMLvgAlerianMLPIfr ETN SerB,1,1,0
461,913254504,NRZ,New Residential,4,3,1
462,913255788,WIX,Wix.com,1,1,0
463,913255890,TERP,TerraForm Power,1,1,0
464,913256612,CME,CME Group,1,1,0
465,913324363,SPN,Superior Energy,1,1,0
466,916040738,WPM,WHEATON PRECIOUS,4,4,0
467,925418532,BILI,Bilibili,1,1,0
468,950056176,IIIV,i3 Verticals,1,1,0
469,913243229,XLK,Technology Select Sector SPDR® ETF,3,3,0
470,913243433,VOO,Vanguard S&P 500 ETF,3,3,0
471,913243989,VNQ,Vanguard Real Estate ETF,3,3,0
472,925305044,OGI,OrganiGram Hldg,3,3,0
473,913255369,HD,Home Depot,5,4,1
474,913255947,OCGN,Ocugen Inc,3,1,2
475,925339541,OPK,OPKO Health,1,1,0
476,925241196,CLSK,CleanSpark,8,4,4
477,950062042,PLTH,PLANET 13,1,0,1
478,913256103,RRR,Red Rock Resorts,1,0,1
479,913254528,STAY,EXTENDED STAY AM,4,1,3
480,913255201,DNR,Denbury Resource,4,1,3
481,913323378,ERIC,Ericsson,6,2,4
482,913257568,SPWR,SunPower,6,2,4
483,913323060,Z,Zillow Group,2,0,2
484,950165278,RPRX,Royalty Pharma plc,1,0,1
485,913256124,INO,Inovio Pharma,3,1,2
486,913323953,NOK,Nokia,2,1,1
487,950164871,VRM,"Vroom, Inc.",10,2,8
488,950053215,VTIQU,Nikola Corporation,2,1,1
489,925239443,DECN,Decision,4,1,3
490,925291522,ACB,Aurora Cannabis Inc,23,12,11
491,925247047,FBRX,Forte Biosciences Inc,25,20,5
492,913255344,GNW,Genworth Fincl,4,4,0
493,913324261,RF,Regions Fincl,4,4,0
494,913323550,TUESQ,Tuesday Mrng,1,0,1
495,913254484,COTY,Coty,7,5,2
496,913257497,SLGN,Silgan Hldg,2,0,2
497,913255865,AGRX,Agile,4,3,1
498,913255907,EARS,Auris Medical Holding Ltd,4,3,1
499,913253524,JAGX,Jaguar Health,5,5,0
500,913253490,BLFS,BioLife,1,0,1
501,913323428,RGEN,Repligen Corp,1,0,1
502,950052407,NMRD,Nemaura Medical Inc,1,0,1
503,950113446,CVET,Covetrus Inc,1,0,1
504,950131931,CSTL,Castle,1,0,1
505,913254417,YELP,Yelp,1,1,0
506,913254679,W,Wayfair,1,0,1
507,950095373,YETI,YETI Holdings,1,0,1
508,913247456,VXX,iPath® S&P 500 VIX ST Futures™ ETN,1,0,1
509,913256419,EBAY,eBay,2,0,2
510,913253746,EXAS,EXACT Sci,1,0,1
511,913324101,WDC,Western Digital,1,0,1
512,913256322,COHU,Cohu,2,1,1
513,913324044,CAR,Avis Budget Grp,1,0,1
514,913323734,MDT,Medtronic,2,0,2
515,913324214,ADUS,Addus Homecare,2,0,2
516,913324651,SEM,Select Mdcl Hldg,2,0,2
517,913254751,AXGT,Axovant Gene Therapies,1,0,1
518,913255145,CSL,Carlisle,1,0,1
519,913256420,FORM,FormFactor,1,0,1
520,925288173,BHVN,Biohaven Pharma,1,0,1
521,950052405,COCP,COCRYSTAL PHARMA,2,2,0
522,913253397,TRNX,Taronis Technologies Inc,6,3,3
523,925330912,SGBX,SG Blocks,1,0,1
524,913255185,DFODQ,Dean Foods,1,1,0
525,913303678,LODE,COMSTOCK MIN,1,1,0
526,913433588,OBLN,Obalon,1,1,0
527,913818664,TEUM,PARETEUM,1,1,0
528,913915241,LKSDQ,LSC Commns,1,1,0
529,925169644,GNMX,Aevi Genomic Med,1,1,0
530,916040664,NRTSF,NOBILIS HEALTH,1,1,0
531,925377113,MDB,MongoDB,1,0,1
532,913324077,MU,Micron Tech,1,0,1
533,950122946,WORK,Slack Technologies,2,1,1
534,913253775,UONEK,URBAN ONE,2,0,2
535,925415705,CRON,Cronos Group,1,0,1
536,925339167,MYO,Myomo,1,1,0
537,950052394,GNPX,Genprex Inc,1,0,1
538,913253629,SBPH,Spring Bk Pharms,1,1,0
539,913254180,NURO,NeuroMetrix,2,1,1
540,925344441,SNNAQ,Sienna,2,1,1
541,913430352,NTNX,Nutanix,1,1,0
542,913255991,RKDA,Arcadia,2,1,1
543,913303841,PTN,PALATIN TECH,1,0,1
544,913323750,MGM,MGM Resorts Intl,1,0,1
545,913255749,SFM,Sprouts Farmers,2,1,1
546,950088252,PHAS,PhaseBio Pharmaceuticals,1,0,1
547,913253439,HTBX,Heat Biologics,1,1,0
548,913254927,AHT,Ashford Hosp,1,1,0
549,913255018,BGG,Briggs,1,1,0
550,913324683,SDRL,Seadrill,1,1,0
551,925241798,GRNQ,Greenpro Capital,2,2,0
552,925418652,DNJR,Golden Bull,1,1,0
553,950056091,ECOR,Electrocore,1,1,0
554,925334627,ALRN,Aileron,1,1,0
555,913323591,NVAX,Novavax,1,1,0
556,913324463,TTI,TETRA,1,0,1
557,913324550,WM,Waste Mgmt,1,0,1
558,913430468,AEZS,Aeterna Zentaris,1,0,1
559,913254305,BAH,Booz Allen,1,0,1
560,913254444,RH,RH,1,0,1
561,913254473,ABBV,AbbVie,3,2,1
562,913254884,DDD,3D Systems,1,0,1
563,913255058,CAG,Conagra Brands,1,0,1
564,913255108,CLX,Clorox,1,0,1
565,913255122,COF,Capital One Fin,1,0,1
566,913255140,CRM,Salesforce.com,1,0,1
567,913255162,CVS,CVS Health,2,1,1
568,913255191,DHI,DR Horton,1,0,1
569,913255418,IEX,IDEX,1,0,1
570,913255681,ZNGA,Zynga,2,1,1
571,913255776,FEYE,FireEye,1,0,1
572,913256043,PYPL,PayPal,3,2,1
573,913256260,CDNS,Cadence Design,1,0,1
574,913256965,CHKP,Chk Pnt Sftwre,1,0,1
575,913257560,INTU,Intuit,1,0,1
576,913323359,ENIA,Enel Americas,1,0,1
577,913324114,PEP,PepsiCo,1,0,1
578,913324421,TGT,Target,8,3,5
579,925200015,AYX,Alteryx,2,1,1
580,925331944,SAFE,Safehold Inc,1,0,1
581,950053121,EQH,Equitable Holdings Inc,1,0,1
582,913303706,NNVC,NANOVIRICIDES,2,1,1
583,913324648,BUD,AB Inbev,1,0,1
584,913253620,MBRX,Moleculin,1,1,0
585,913257034,BIIB,Biogen,1,0,1
586,950032088,LLKKF,Lake Resources NL,1,1,0
587,950113858,CTRM,Castor Maritime Inc,2,1,1
588,925412942,TMFC,Motley Fool 100 ETF,15,4,11
589,950155409,WMG,Warner Music Group,2,1,1
590,913255946,VBLT,VASCULAR,6,2,4
591,913257355,RNWK,RealNetworks,4,3,1
592,913323301,ATHE,Alterity Therapeutics Ltd,4,4,0
593,913254171,CHCI,Comstock Hldg,1,1,0
594,925338986,APHA,Aphria Inc,5,2,3
595,913324644,AI,Arlington Asset,3,0,3
596,913255660,UI,Ubiquiti Inc,2,0,2
597,925301597,CRCW,Crypto,1,0,1
598,925336203,BTSC,Bitcoin Services,1,0,1
599,925336288,BITCF,First Bitcoin,1,0,1
600,925411525,ETHEREUM XBT,XBT Provider Ether Tracker One ETN,1,0,1
601,925417468,Bitcoin/XBTE/EU,XBT Provider Bitcoin Tracker EUR ETN,1,0,1
602,913255924,NVUS,Novus,1,1,0
603,913245861,AMLP,Alerian MLP ETF,1,0,1
604,913323879,NAT,Nordic Amer Tank,3,3,0
605,925409559,CUE,Cue Biopharma,1,0,1
606,913257121,RIGL,Rigel Pharms,1,1,0
607,913256040,ZYNE,Zynerba Pharms,2,0,2
608,913433510,CPAH,CounterPath,1,1,0
609,913253333,CJJD,China Jo-Jo,2,0,2
610,913903088,XBIO,Xenetic,4,1,3
611,913253509,VKTX,Viking Therapeut,1,0,1
612,913256082,PTI,Proteostasis,1,1,0
613,913324115,PEG,PSEG,1,0,1
614,913303708,CANF,CAN FITE BIOPHAR,1,1,0
615,913253440,ONTX,Onconova,2,2,0
616,913253552,HEPA,Hepion Pharmaceuticals Inc,1,1,0
617,913256150,ACOR,Acorda,3,1,2
618,913256006,LIFE,aTyr Pharma,1,1,0
619,950116150,DTIL,Precision BioSciences,1,1,0
620,913253445,CGIX,CANCER GENETICS,3,1,2
621,950032077,PAYS,PaySign Inc,1,0,1
622,913253448,SPCB,Supercom,1,0,1
623,913255679,GRPN,Groupon,1,0,1
624,913323710,JAKK,JAKKS Pacific,1,0,1
625,925377976,REDU,RISE Education,1,0,1
626,913254675,ICD,Indpdnc Cntct,1,0,1
627,925240176,CREX,CREATIVE REALITI,1,1,0
628,918493474,INSG,Inseego,1,0,1
629,950130391,LMPX,Lmp Automotive Holdings Inc,1,0,1
630,913255942,ERI,Eldorado,1,1,0
631,913253633,VIVE,Viveve Medical,1,0,1
632,950118384,DSSI,Diamond S Shipping Inc,1,1,0
633,950099070,GHSI,Guardion Health Sciences,1,0,1
634,913253455,ADXS,Advaxis,1,1,0
635,913303837,PLX,PROTALIX BIOTHER,1,0,1
636,913253774,SLS,SELLAS LIFE SCIE,1,1,0
637,950061378,TLRY,"TILRAY, INC.",3,1,2
638,913324681,STNG,Scorpio Tankers,1,0,1
639,913254641,CMCM,Cheetah Mobile,2,2,0
640,913303870,VHC,VIRNETX HOLDING,1,0,1
641,925310607,USOI,Credit Suisse X-Lnks Crde OlShrsCvCllETN,2,1,1
642,913256359,CSCO,Cisco Systems,1,0,1
643,913254838,TWO,Two Harbors,3,2,1
644,913324293,RWT,Redwood Trust,1,1,0
645,913254685,USDP,USD Partners,2,1,1
646,913255773,CPTA,Capitala Finance,2,1,1
647,913257239,GLAD,Gladstone Cap,2,1,1
648,913254640,FSK,FS KKR Capital Corp,1,1,0
649,925297216,SVM,Silvercorp Metal,7,4,3
650,913324649,CLNY,Colony Capital Inc,2,2,0
651,913324343,SNA,Snap-On,1,0,1
652,950138690,VIE,Viela Bio Inc,1,0,1
653,913254942,ALK,Alaska Air Group,2,1,1
654,913257564,HA,Hawaiian Hldg,1,0,1
655,913255699,SPLK,Splunk,4,2,2
656,913323524,TTWO,Take-Two,2,0,2
657,913255250,ENS,EnerSys,2,1,1
658,913324675,GNRC,Generac Hldg,2,1,1
659,913430407,EVBG,Everbridge,2,1,1
660,913255663,CHEF,Chefs' Warehouse,6,2,4
661,916040700,SNDE,Sundance Energy,5,3,2
662,913244550,XBI,SPDR® S&P Biotech ETF,1,1,0
663,913255452,KBH,KB Home,3,2,1
664,913255489,LLY,Lilly,1,1,0
665,913255495,LOW,Lowes,1,1,0
666,913324489,UNH,UnitedHealth,1,1,0
667,916040713,VBIV,VBI Vaccines,1,1,0
668,950076873,SXTC,"CHINA SXT PHARMACEUTICALS, INC.",1,1,0
669,950136923,SDC,SMILEDIRECTCLUB,1,1,0
670,913254551,BURL,Burlington,1,0,1
671,913255509,MA,Mastercard,1,0,1
672,913255864,JD,JD.com,1,0,1
673,913255661,CLVS,Clovis Oncology,1,1,0
674,950052673,ASLN,Aslan Pharms,1,1,0
675,913254465,WDAY,Workday,3,1,2
676,913255714,FIVE,fiveBelow,3,1,2
677,913255894,HQY,HealthEquity,3,1,2
678,913323573,ULTA,Ulta Beauty,3,1,2
679,925416316,ZS,ZSCALER,3,1,2
680,950126602,CRWD,Crowdstrike,3,1,2
681,950061739,CNST,Constellation Pharmaceuticals,1,1,0
682,913257472,SBUX,Starbucks,2,1,1
683,913323809,MRK,Merck & Co,3,2,1
684,913255105,CMG,Chipotle,1,1,0
685,913257268,INTC,Intel,1,1,0
686,913323778,MMM,3M,1,1,0
687,913254831,TWLO,TWILIO,1,1,0
688,913255610,NXPI,NXP Semicondtrs,1,1,0
689,913255993,ETSY,Etsy,3,3,0
690,913256142,ABMD,Abiomed,1,1,0
691,913324471,TREX,Trex Co,1,1,0
692,950116149,LYFT,Lyft,1,1,0
693,913324123,PG,Procter Gamble,1,1,0
694,913324432,TJX,TJX,1,0,1
695,913253677,BLIN,Bridgeline Dig,1,1,0
696,913254242,CLSN,Celsion,1,1,0
697,913254447,PANW,Palo Alto,1,1,0
698,913254448,DKL,Delek Logistics,1,1,0
699,913254896,A,Agilent,1,1,0
700,913255026,BKE,Buckle,1,1,0
701,913255735,TTPH,Tetraphase,1,1,0
702,913303675,NAVB,NAVIDEA BIOPHARM,1,1,0
703,913432197,NY.ID,NYSE TOP US 100 Index,1,1,0
704,925411387,ENTX,Entera,1,1,0
705,950056867,ONCY,Oncolytics Biotech,1,1,0
706,950131937,NETC,NETCOMPANY,1,1,0
707,950133162,SNDL,SUNDIAL GROWERS INC.,1,1,0
708,950052406,CTXR,Citius Pharmaceuticals Inc,1,1,0
709,913254348,GNC,GNC Hldg,1,0,1
710,916040665,BTE,Baytex Energy,1,0,1
